0		2	3	4	5	6	7	8	9	10	11	12	13	14	15	16	17	18	19	20	21	22	23	24	25	26	27	28	29	30	31	32	33	34	35	36	37	38	39
40		42	43	44	45	46		48	49	50	51	52	53	54	55	56	57	58	59	60	61	62	63	64	65	66	67	68	69	70	71	72	73	74	75	76	77	78	79
80								88	89																												117	118	119
120		122	123	124	125	126	127	128	129		131	132		134	135	136	137	138	139	140	141	142	143	144	145	146	147	148	149	150	151	152	153	154	155		157	158	159
160								168	169		171	172		174	175	176	177	178	179	180	181	182	183	184	185	186	187	188	189	190	191	192	193	194	195		197	198	199
200	201	202		204	205	206		208	209		211	212		214	215																						237	238	239
240	241	242			245	246		248	249		251	252		254	255		257	258	259	260	261	262	263	264	265	266	267	268	269	270	271	272	273	274	275	276	277	278	279
280	281	282	283		285	286		288	289		291	292		294	295		297	298	299	300	301	302	303	304	305	306	307	308	309	310	311	312							319
320	321	322	323	324	325	326		328	329		331	332		334	335														349	350	351			354	355	356	357	358	359
360	361							368	369		371	372		374	375	376	377	378	379	380	381	382	383	384	385	386	387		389	390	391		393	394	395	396	397	398	399
400	401		403	404	405	406		408	409		411	412			415	416	417	418	419	420	421	422			425	426	427						433	434	435				439
440	441		443	444	445	446	447	448	449		451	452	453								461	462		464	465	466	467		469	470	471		473	474	475		477		479
480	481		483	484	485	486	487	488	489		491	492	493	494	495	496	497	498	499					504	505	506	507		509	510	511		513	514			517		519
520	521								529		531	532	533	534	535	536	537	538	539	540	541	542	543	544	545	546	547		549	550	551					556	557		559
560	561		563	564		566	567		569		571	572																	589	590	591	592	593	594	595	596	597		599
600	601		603	604		606	607	608	609		611	612		614	615	616	617	618	619	620	621	622	623	624	625	626	627	628	629	630	631	632	633	634	635	636	637	638	639
640	641		643	644		646	647	648	649		651	652		654	655	656	657	658	659	660	661	662	663	664									673	674	675	676	677	678	679
680	681										691	692					697	698								706	707	708	709	710	711							718	719
720	721	722	723	724	725	726	727	728	729	730	731	732		734	735		737	738		740	741	742	743	744	745	746	747	748	749	750	751	752	753	754	755	756		758	759
760	761	762	763	764	765	766	767	768	769	770	771	772		774	775		777	778		780	781	782										792	793	794	795	796		798	799
800	801													814	815					820	821	822		824	825	826	827	828	829	830		832	833	834	835	836			839
840	841		843	844	845		847	848	849	850	851	852	853	854	855	856	857	858	859	860	861	862		864	865	866	867	868	869	870		872	873	874	875	876	877		879
880	881		883	884	885						891	892	893	894	895	896	897	898	899	900	901	902		904	905	906	907	908	909	910					915	916	917		919
920	921		923	924	925	926	927	928	929				933	934										944	945	946	947	948	949	950	951	952	953		955	956	957		959
960	961		963	964	965	966	967	968	969	970	971		973	974		976	977	978		980	981	982	983	984	985	986	987	988	989	990	991	992	993		995	996	997	998	999
1000	1001								1009	1010	1011		1013	1014		1016	1017	1018		1020	1021	1022	1023	1024	1025	1026	1027						1033					1038	1039
1040	1041	1042	1043		1045	1046	1047		1049	1050	1051		1053	1054		1056	1057	1058							1065	1066	1067		1069	1070	1071		1073	1074	1075	1076		1078	1079
1080	1081	1082	1083		1085	1086	1087									1096	1097	1098	1099	1100	1101	1102	1103		1105	1106	1107		1109	1110	1111		1113	1114	1115	1116			1119
1120	1121	1122			1125	1126	1127	1128	1129	1130	1131	1132	1133	1134	1135	1136	1137	1138	1139	1140	1141	1142	1143						1149	1150	1151					1156	1157		1159
1160	1161	1162	1163	1164	1165	1166	1167	1168	1169	1170	1171	1172	1173	1174	1175	1176	1177	1178	1179	1180	1181	1182	1183	1184	1185	1186	1187	1188	1189	1190	1191	1192	1193	1194	1195	1196	1197		1199

