0		2	3	4	5	6	7	8	9	10	11	12	13	14	15	16	17	18	19	20	21	22	23	24	25	26	27	28	29	30	31	32	33	34	35	36	37	38	39
40		42	43	44		46	47	48	49	50	51	52	53	54	55	56												68	69	70	71	72	73	74	75	76	77	78	79
80		82	83	84		86	87	88		90	91					96		98	99	100	101	102	103		105	106		108	109	110	111	112	113	114	115	116	117	118	119
120		122											133	134		136		138	139	140	141	142	143		145	146							153	154	155	156	157	158	159
160		162		164		166		168		170	171		173	174		176												188	189	190	191		193	194	195	196	197	198	199
200						206		208		210	211					216		218	219	220	221		223	224		226	227	228	229	230	231		233	234					239
240		242	243		245	246		248		250	251		253	254	255	256					261						267	268	269	270	271		273	274		276	277		279
280		282	283		285	286		288		290	291		293	294	295	296		298	299		301	302	303		305								313	314		316	317		319
320													333	334	335	336		338	339		341	342	343		345	346	347	348	349	350		352	353	354		356	357		359
360		362		364	365		367	368		370	371					376					381	382															397		399
400		402		404	405					410	411		413	414	415	416		418	419		421	422		424		426		428	429		431	432		434	435		437	438	439
440		442		444	445		447	448		450	451	452	453	454	455	456		458	459		461	462		464		466		468	469		471	472		474	475		477	478	479
480																496												508						514	515		517	518	519
520		522		524	525		527		529	530	531	532	533	534	535	536		538	539		541	542	543	544	545	546	547	548	549	550	551	552					557		559
560		562		564	565		567		569	570	571	572	573	574	575	576		578	579		581	582								590	591	592		594	595		597		599
600		602		604	605		607		609	610								618	619		621	622		624	625		627	628						634	635		637		639
640		642		644	645		647		649	650		652	653		655	656		658	659		661	662		664	665		667	668		670	671	672		674	675		677		679
680												692	693		695	696		698	699											710	711	712		714	715		717		719
720		722	723		725	726	727	728	729	730	731	732	733		735	736					741	742		744	745		747	748						754	755		757		759
760		762	763		765	766	767	768	769	770	771	772	773		775	776	777	778	779		781	782		784	785		787	788		790		792		794	795		797		799
800					805	806	807			810							817				821	822								830		832		834	835		837		839
840		842	843		845	846	847		849	850	851		853	854		856	857		859	860	861	862		864	865	866		868	869	870		872		874	875		877		879
880		882	883		885	886	887		889	890	891		893	894		896	897		899	900	901	902			905									914	915		917		919
920					925	926	927		929	930	931	932	933	934		936	937							944	945	946		948	949		951	952	953	954	955		957		959
960	961		963	964	965	966	967		969	970	971		973	974		976	977	978	979	980		982	983	984	985	986		988	989				993				997		999
1000	1001		1003	1004	1005	1006	1007									1016	1017	1018	1019	1020											1031	1032	1033		1035	1036	1037		1039
1040	1041		1043	1044	1045	1046	1047		1049	1050	1051		1053	1054	1055	1056	1057	1058	1059	1060		1062	1063	1064		1066	1067	1068	1069				1073						1079
1080	1081								1089	1090	1091												1103	1104							1111	1112	1113	1114	1115	1116	1117		1119
1120	1121	1122	1123	1124	1125	1126	1127	1128	1129	1130	1131	1132	1133	1134	1135	1136	1137	1138	1139	1140	1141					1146	1147	1148	1149	1150	1151	1152	1153	1154	1155	1156	1157		1159
1160	1161	1162	1163	1164	1165	1166	1167	1168	1169	1170	1171	1172	1173	1174	1175	1176	1177	1178	1179	1180	1181	1182	1183	1184	1185	1186	1187	1188	1189	1190	1191	1192	1193	1194	1195	1196	1197		1199

