0		2	3	4	5	6	7	8	9	10	11	12	13	14	15	16	17	18	19	20	21	22	23	24	25	26	27	28	29	30	31	32	33	34	35	36	37	38	39
40		42	43	44	45	46	47	48	49	50	51	52	53	54	55	56	57	58	59	60	61	62	63	64	65	66	67	68	69	70	71	72	73	74	75	76	77	78	79
80		82	83	84	85	86	87	88	89	90	91	92	93	94																				114	115	116	117	118	119
120		122	123	124							131	132	133	134		136	137	138	139		141	142	143	144	145	146	147	148	149	150	151	152	153	154	155			158	159
160		162	163	164		166	167	168	169		171	172	173	174	175	176	177	178	179		181	182	183	184	185	186	187	188	189	190	191	192	193	194	195		197	198	199
200		202	203	204		206	207	208	209		211	212	213	214	215	216	217	218	219										229	230	231	232					237	238	239
240						246	247	248	249		251	252	253	254	255						261	262	263		265	266	267		269	270	271	272		274	275	276	277	278	279
280	281		283	284	285	286	287	288	289		291	292	293	294	295		297	298	299	300	301	302	303		305	306								314	315	316	317	318	319
320	321		323	324	325	326	327	328	329		331	332					337	338	339	340	341	342	343		345	346		348	349	350		352	353	354	355	356	357	358	359
360	361		363	364	365	366	367	368	369		371	372		374	375	376	377	378	379						385	386		388	389	390		392	393	394	395	396	397	398	399
400	401		403	404	405				409		411	412		414	415	416	417	418	419		421	422	423	424	425	426		428	429	430		432	433	434	435	436	437	438	439
440	441		443	444	445		447	448	449												461	462	463					468	469	470		472	473	474	475	476	477	478	479
480	481						487	488	489		491	492	493	494	495	496		498	499	500	501	502	503		505	506	507	508	509	510					515	516	517	518	519
520	521	522		524	525	526	527	528	529		531	532	533	534	535	536		538	539	540	541	542	543		545	546	547	548	549	550		552	553		555	556	557	558	559
560	561	562		564	565	566	567	568	569		571	572	573	574	575	576		578	579	580	581	582	583		585	586	587	588	589	590		592	593		595	596	597	598	599
600	601	602		604	605						611	612				616		618	619	620	621	622	623		625							632	633		635	636	637	638	639
640				644			647	648		650	651	652		654	655	656		658	659	660	661	662	663		665		667	668	669	670	671	672	673		675	676	677	678	679
680		682		684		686	687	688		690	691	692		694	695	696									705		707	708	709	710	711	712	713					718	719
720		722				726	727	728						734	735	736		738	739	740	741	742	743	744	745								753	754	755	756		758	759
760		762	763	764	765	766	767	768	769		771	772	773	774	775	776		778	779	780		782	783	784	785	786	787	788	789	790	791	792	793	794	795	796		798	799
800		802	803	804	805	806	807	808	809		811	812	813					818	819	820		822	823	824	825	826	827	828	829	830	831	832	833	834	835	836		838	839
840		842	843	844	845	846	847	848	849		851	852	853		855	856	857	858	859	860				864	865	866	867	868	869	870	871	872	873	874	875	876		878	879
880		882	883	884	885	886	887	888	889		891	892	893		895	896	897	898	899	900	901	902		904	905	906	907											918	919
920		922	923	924	925										935	936	937	938	939	940	941	942		944	945	946	947		949	950	951	952	953	954	955	956	957	958	959
960		962	963	964	965		967	968	969	970	971		973	974	975	976	977							984	985	986	987		989	990	991	992	993	994	995	996	997	998	999
1000		1002					1007	1008	1009	1010	1011		1013	1014	1015	1016	1017		1019	1020		1022	1023	1024	1025	1026	1027		1029	1030	1031	1032	1033	1034	1035	1036	1037	1038	1039
1040		1042		1044	1045	1046	1047	1048	1049	1050	1051					1056	1057		1059	1060		1062	1063	1064	1065	1066	1067											1078	1079
1080				1084	1085	1086	1087	1088	1089	1090	1091	1092	1093	1094					1099	1100						1106	1107	1108	1109	1110	1111	1112	1113	1114	1115	1116			1119
1120	1121	1122	1123	1124	1125	1126	1127	1128	1129	1130	1131	1132	1133	1134	1135	1136	1137	1138	1139	1140	1141	1142	1143	1144	1145	1146	1147	1148	1149	1150	1151	1152	1153	1154	1155	1156	1157		1159
1160	1161	1162	1163	1164	1165	1166	1167	1168	1169	1170	1171	1172	1173	1174	1175	1176	1177	1178	1179	1180	1181	1182	1183	1184	1185	1186	1187	1188	1189	1190	1191	1192	1193	1194	1195	1196	1197		1199

